20
20
00000000000000000000
00021111200000000000
00010000211120000000
00010000100021111120
00021111200010000010
00010000200010000010
00010000100010000010
00021111200021112120
00010000100010001000
00021111211120001000
02120000000010001000
01000000000010001000
01000000000010001000
02111111120010001000
01000000010010001000
02111112121122001000
01000001000001001000
01000001000002112000
02111112111112000000
00000000000000000000